SO textures/cube_wall_3.xpm
NO textures/cube_wall_4.xpm
WE textures/cube_wall_2.xpm
EA textures/cube_wall_1.xpm
F   255,255,153
C 255,255,102

                           111
                           1N1
 1111111111111111111111111 101
 1000000000000000000000001 101
 1011111111111111111111101 101
 101                   101 101
 101 111111111111111111101 101
 101 100000000000000000001 101
 101 111111111111111111111 101
 101                       101
 10111111111111111111111111101
 10000000000000000000000000001
 11111111111111111111111111111